barat	n
membaratkan	v
baratan	n
pembarat	n
pembaratan	n
kebarat-baratan	a
dan	p
timur	n
menimur	v
ketimuran	n
adalah	v
guru	n
berguru	v
menggurui	v
perguruan	n
keguruan	n
muslim	n
hindu	n
berhindu	v
Kristen	n
mengkristenkan	v
kekristenan	n
Buddha	n
ikut	v
ikut-ikut	v
berikut 	v
mengikut	n
mengikuti	v
mengikutkan	v
ikutan	v
ikut-ikutan	n
terikut	v
memperikut	v
memperikutkan	v
pengikut	v
Zen	n
taocang	n
semua	num
semuanya	adv
semua-muanya	adv
dari	p
sedari	p
orang	n
berorang-orang	v
mengorangkan	v
orang-orangan	n
perseorangan	n
seorang	n
perorangan	n
keseorangan	n
seseorang	n
saleh	a
kesalehan	n
berani	a
berani-berani	a
berberani-berani	v
memberanikan	v
terberanikan	v
pemberani	n
keberanian	n
rahasia 	n
berahasia	n
merahasiakan	n
rahasia-rahasiaan	n
kerahasiaan	n
cinta	a
bercinta	v
bercinta-cintaan	v
bercintakan	v
mencinta	v
mencintai	v
mencintakan	v
tercinta	v
percintaan	n
pencinta	n
kecintaan	n
bara	n
membara	v
perbaraan	n
jadi	v
menjadi	v
menjadikan	v
menjadi-jadi	v
menjadi-jadikan	v
terjadi	v
jadi-jadian	n
penjadi	n
penjadian	n
kejadian 	n
sejadi-jadinya	v
api	n
berapi	v
berapi-api	a
mengapi	v
mengapi-apikan	v
perapian	n
memperapikan	v
merah	n
memerah	a
memerahi	v
memerahkan	v
pemerah	v
kemerahan	n
kemerah-merahan	n
tikar	n
sembahyang	n
bersembahyang	v
menyembahyangi	v
menyembahyangkan	v
sembahyangan	n
persembahyangan	n
pelana	n
berpelana	v
memelana	v
tuju	v
menuju	v
menujui	v
menujukan	v
tertuju	v
tujuan	n
bertujuan	v
penuju 	a
setuju 	n
bersetuju	n
menyetujui	v
menyetujukan	a
mempersetujukan	v
persetujuan	v
setujuan	v
bersetujuan	v
kesetujuan	v
arasy	n
ya	p
makam	n
anak	n
anak-anak	a
beranak 	n
anak-beranak	v
anakan	n
anak-anakan	n
peranakan	n
memperanakkan	n
laocu	n
howitzer	n
Almasih	n
serta	p
Muhammad	n
Rasulullah	n
hanya	adv
di	p
masjid	n
permasjidan	n
aku	pron
beraku	v
beraku-akuan	v
mengaku	v
mengakui	v
mengakukan	v
akuan	n
pengaku	n
pengakuan	n
keakuan	n
khidmat	a
berkhidmat	v
kekhidmatan	n
walau	p
jejak	n
berjejak	v
menjejak	v
menjejaki	v
menjejakkan	v
penjejak	n
mana	pron
mana-mana	pron
tetapi	p
sebagai	p|adv
bagai	p|n
berbagai	v
berbagai-bagai	v
keberbagaian	n
bagaikan	p
membagaikan	v
memperbagai-bagaikan	v
